NO ./textures/texture_wall2_64.xpm
SO ./textures/texture_wall1_64.xpm
EA ./textures/texture_wall3_64.xpm
WE ./textures/texture_wall4_64.xpm

F 100,0,100
C 0,0,100

DO tex/metal.xpm

        1111111111111111111111111
        1000000001110000000000001
111111111111000000000000000000001
1   100000000000001000000001111111111111111111111111111111111111111111111111111111111111
1   10000011000001110000000000000000000000000000000000000000000000000000000000000000001
111110000110000011100011000111111111111111111111111111111111111111111111111111111111111
11110001111111001100000010001
11110001100011001100100010001
11000000000001001100000000001
10000000000000000000000000001
10000000000000000000000000001
10000000000000001000010000001
1100000111000001110001110000111
11000111 1100101 100111000N11
11111111 1111111 111111111111
